0000000000000000000000000
0111111111111111111111110
0111113311111111113311110
0112111111111111111311110
0111111111111111111311110
0111111111111111111111110
0111111111111111111111110
0333311111111111111111110
0333111111111111113311110
0333311111111111113211110
0111111111111111112111110
0111111111111111111111110
0111133333333333333311110
0111111111111111111111110
0111111111111111111111110
0331111111111111111111330
0331111111111111111111330
0111111111111133311111110
0111111111111133311111110
0111111111111111111111110