2222222222222222222222222
2333333333333333333333332
2111333333333333333333332
2333331133333333333113312
2333333333113331133333332
2333333333333333333331112
2333333333333333311333332
2333333331133113333333332
2113311333333333333333332
2331333333333333333333332
2333133333333333333333332
2333313333333333333333332
2333331133311133113113332
2333333333333333333333332
2333333333333333333331112
2333333113331133311333332
2331133333333333333333322
2333333333333333333333222
2111111133311333113311112
2222222222222222222222222